Northern and Eastern Ontario	Trick_Bar_1439	NDP
Liberal #3	Zhuk236	Liberal
Montreal	Model-EpicMFan	NDP
Fraser-Columbia and the North	WonderOverYander	Liberal
Quebec City-Eastern and Northern Quebec	raymondl810	Conservative
Vancouver and the Islands	ThomasKaffee	Conservative
Conservative #2	realbassist	Conservative
Laval-Gatineau-North Shore	Lady_Aya	Independent
Alberta South	NinjjaDragon	NDP
Conservative #3	AdSea260	Conservative
Golden Horseshoe	jeninhenin	Conservative
Conservative #4	cheeselover129	Conservative
Central Ontario	SettingObvious4738	Liberal
Southwestern Ontario	Hayley182_	Conservative
Atlantic Canada	PhlebotinumEddie	NDP
Liberal #1	zetix026	Liberal
Prairies	SaskPoliticker	Liberal
Liberal #2	0hw3n	Liberal
Centre of Quebec and Eastern Townships	Vacant	Vacant
NDP #3	michaeldgrant2	NDP
Territories	Scribba25	NDP
Toronto	Vacant	Vacant
Liberal #4	JaacTreee	Liberal
NDP #2	MrWhiteyIsAwesome	NDP
Conservative #1	Vacant	Conservative
NDP #1	ConfidentIt	NDP
Alberta North	username222222345	NDP